NO    ./texture/bluestone.xpm


SO ./texture/greystone.xpm
WE ./texture/bluestone.xpm

EA    ./texture/bluestone.xpm
F     220,10,130


C 25,10,255


1111111111111111111111111111111111111111111111111111111111111111111111111111111111111111111111111
1000000001000100010000000001000000000000000000001000000000000010000000000000000000000100000010001
1000000001001110010000000001000000000000000000001000000000000010000000000000000000000100000010001
1000000001000100010000000001000000000000000000001000000000000010000000000000000000111100000010001
1000000001001110010000000001000000000000000000001000000000000010000000000000000000100100000000001
1000000001000100010000000001000000000000000000001101111111110111111111111111111111100100000010001
1000000001000100010000000000000000000000000000000000000000000000000000000000000000000000000010001
1000000001011111010011111111000000000000000000001111101111111110001111111111101110111100000010001
100000000000000000001      1000000000000000000001000001000010010001000000100000100000100000010001
100000000000000000001      1000000000000000000001000001000010010101000000100000111111100000010001
100000000100000000001      1000000000000000000001000001000010011111000000100000100000000000010001
100000000111011111001      1111111111111111111111111111111111111111111111111111111011111111110001
1000000001 1N1   1111                                                         1000000000000000001
1000000001 111                                                                1000000000000000001
1000000001                                                                    1000000000000000001
1000000001                                                                    1000000000000000001
1000000001                                                                    1000000000000000001
1000000001                                                                    1111111111111111111
1111110011
1000100001
1000100001
1111100001
1000000001
1000000001
1000000001
1111111111