BLOCK ./texture/DOOR_WIND.xpm 2
BLOCK ./texture/TECH_2A.xpm 1
OBJ ./texture/pillar.xpm p
OBJ ./texture/greenlight.xpm b
OBJ ./texture/pillar.xpm c 1
VWALL ./texture/DOOR_WIND.xpm 57 1

DOOR  ./texture/LIGHT_1B.xpm

F 180,180,180
C 200,200,200


11111111111111111
10000000000000002
10p0c000000000p01
10000000000000002
10000000000000001
10000000000000002
10000000000000001
1000000N000000002
10000000000000001
10000000000000001
10p00000000000p01
10000000000000001
11111111111111111