BLOCK ./texture/DOOR_WIND.xpm 1
BLOCK ./texture/TECH_2A.xpm 2
BLOCK ./texture/TECH_2A.xpm 3 0
OBJ ./texture/pillar.xpm p
OBJ ./texture/babyfoot.xpm b
DOOR  ./texture/LIGHT_1B.xpm

F 180,180,180
C 200,200,200


                           333333333333333333333333333333333
                           100000000000000000000000000000003
    11111122222111111111111111111111111111111111111111111003
   100000200200200000200000000002000002000000000000200001003
  1000000200200200000200000000002000002000000000000200001003
 10000000200200200000200000000002000002000000000000200001003
100000000200200200000200000000002000002000000000222220001003
100000000200200200000200000000002022202222222222200220001003
100000000200200200000000000E00000000000000000000000000001003
1000000002-222-2-2222200000000002202202002222020222220001003
100000000200000002   200000000002002002002 20020022200001003
100000000|00000002   200000b00002002002002 20020022200001003
100000000200000002   200000000002002002002 20020020000001003
100000000222022202   211111111111111112222 11111111011111003
10000p0002222  202                               30000000003
1000000000001  222                               30000000003
10000p0000001                                    30000000003
1000000000001                                    33333333333
10000p0000001                                                                  
1000000000001                                                                  
1222222202221
1000000200001
1000000200001
1000000200001
1222222200001
1000000000001
1000000000001
1000000000001
1000000000001
1000000000001
1000000000001
2222222222222