BLOCK ./texture/DOOR_WIND.xpm 1
BLOCK ./texture/TECH_2A.xpm 2
OBJ ./texture/pillar.xpm p
DOOR ./texture/LIGHT_1B.xpm

F 180,180,180
C 200,200,200


                           111111111111111111111111111111111
                           100000000000000000000000000000001
    11111122222111111111111111111111111111111111111111111001
   100000200200200000200000000002000002000000000000200001001
  1000000200200200000200000000002000002000000000000200001001
 10000000200200200000200000000002000002000000000000200001001
100000000200200200000200000000002000002000000000222220001001
100000000200200200000200000000002022202222222222200220001001
100000000200200200000000000E00000000000000000000000000001001
1000000002-222-2-2222200000000002202202002222020222220001001
100000000200000002   200000000002002002002 20020022200001001
100000000|00000002   200000000002002002002 20020022200001001
100000000200000002   200000000002002002002 20020020000001001
100000000222022202   211111111111111112222 11111111011111001
10000p0002222  202                               10000000001
1000000000001  222                               10000000001
10000p0000001                                    10000000001
1000000000001                                    11111111111
10000p0000001                                                                  
1000000000001                                                                  
1222222202221
1000000200001
1000000200001
1000000200001
1222222200001
1000000000001
1000000000001
1000000000001
1000000000001
1000000000001
1000000000001
2222222222222